111111111111111
10P100000000001
100000000000001
1000000C0000001
100000000000E01
111111111111111