111111111111111
10P000000000001
1000C0000000001
100000000C00001
100000000000E01
111111111111111