1111111111111111111111111111111
110000P000001110C01000000000001
11100000000C001000100000C000001
1110000000000010001000000000001
1111100000000010001000000000001
1110000000000000000000000000001
1000C00000000000000000000000001
1000000000000000000000000000001
1100000000000000000000001000001
1111100000000000000000001000001
11111110000000C000000000100E001
1111111111111111111111111111111